size 10 10
1111111111
1100000011
1002020201
1020002001
1000200001
1000020001
1020002001
1002020201
1100000011
1111111111
